111111111111
1000000E0001
1000C00P0001
111111111111
